surah_number,surah_name,ayah_number,reciter,word_number,start_time_ms,end_time_ms,duration_ms,audio_url
1,Al-Fatiha,1,Abdul Basit,1,0,920,920,https://audio-cdn.tarteel.ai/quran/abdulBasitMurattal/001001.mp3
1,Al-Fatiha,1,Abdul Basit,2,1080,1440,360,https://audio-cdn.tarteel.ai/quran/abdulBasitMurattal/001001.mp3
1,Al-Fatiha,1,Abdul Basit,3,2120,2440,320,https://audio-cdn.tarteel.ai/quran/abdulBasitMurattal/001001.mp3
1,Al-Fatiha,1,Abdul Basit,4,2680,4360,1680,https://audio-cdn.tarteel.ai/quran/abdulBasitMurattal/001001.mp3
1,Al-Fatiha,2,Abdul Basit,1,1200,1600,400,https://audio-cdn.tarteel.ai/quran/abdulBasitMurattal/001002.mp3
1,Al-Fatiha,2,Abdul Basit,2,1930,2030,100,https://audio-cdn.tarteel.ai/quran/abdulBasitMurattal/001002.mp3
1,Al-Fatiha,2,Abdul Basit,3,2730,2830,100,https://audio-cdn.tarteel.ai/quran/abdulBasitMurattal/001002.mp3
1,Al-Fatiha,2,Abdul Basit,4,2960,5280,2320,https://audio-cdn.tarteel.ai/quran/abdulBasitMurattal/001002.mp3
1,Al-Fatiha,3,Abdul Basit,1,1480,1800,320,https://audio-cdn.tarteel.ai/quran/abdulBasitMurattal/001003.mp3
1,Al-Fatiha,3,Abdul Basit,2,2040,4000,1960,https://audio-cdn.tarteel.ai/quran/abdulBasitMurattal/001003.mp3
1,Al-Fatiha,4,Abdul Basit,1,0,1800,1800,https://audio-cdn.tarteel.ai/quran/abdulBasitMurattal/001004.mp3
1,Al-Fatiha,4,Abdul Basit,2,1960,2400,440,https://audio-cdn.tarteel.ai/quran/abdulBasitMurattal/001004.mp3
1,Al-Fatiha,4,Abdul Basit,3,2680,4520,1840,https://audio-cdn.tarteel.ai/quran/abdulBasitMurattal/001004.mp3
1,Al-Fatiha,5,Abdul Basit,1,0,1440,1440,https://audio-cdn.tarteel.ai/quran/abdulBasitMurattal/001005.mp3
1,Al-Fatiha,5,Abdul Basit,2,1600,2280,680,https://audio-cdn.tarteel.ai/quran/abdulBasitMurattal/001005.mp3
1,Al-Fatiha,5,Abdul Basit,3,2360,3200,840,https://audio-cdn.tarteel.ai/quran/abdulBasitMurattal/001005.mp3
1,Al-Fatiha,5,Abdul Basit,4,3400,5600,2200,https://audio-cdn.tarteel.ai/quran/abdulBasitMurattal/001005.mp3
1,Al-Fatiha,6,Abdul Basit,1,0,1440,1440,https://audio-cdn.tarteel.ai/quran/abdulBasitMurattal/001006.mp3
1,Al-Fatiha,6,Abdul Basit,2,1680,2200,520,https://audio-cdn.tarteel.ai/quran/abdulBasitMurattal/001006.mp3
1,Al-Fatiha,6,Abdul Basit,3,2520,4800,2280,https://audio-cdn.tarteel.ai/quran/abdulBasitMurattal/001006.mp3
1,Al-Fatiha,7,Abdul Basit,1,0,2160,2160,https://audio-cdn.tarteel.ai/quran/abdulBasitMurattal/001007.mp3
1,Al-Fatiha,7,Abdul Basit,2,2400,2760,360,https://audio-cdn.tarteel.ai/quran/abdulBasitMurattal/001007.mp3
1,Al-Fatiha,7,Abdul Basit,3,3120,3840,720,https://audio-cdn.tarteel.ai/quran/abdulBasitMurattal/001007.mp3
1,Al-Fatiha,7,Abdul Basit,4,4240,4560,320,https://audio-cdn.tarteel.ai/quran/abdulBasitMurattal/001007.mp3
1,Al-Fatiha,7,Abdul Basit,5,4760,4880,120,https://audio-cdn.tarteel.ai/quran/abdulBasitMurattal/001007.mp3
1,Al-Fatiha,7,Abdul Basit,6,5600,6360,760,https://audio-cdn.tarteel.ai/quran/abdulBasitMurattal/001007.mp3
1,Al-Fatiha,7,Abdul Basit,7,6720,7080,360,https://audio-cdn.tarteel.ai/quran/abdulBasitMurattal/001007.mp3
1,Al-Fatiha,7,Abdul Basit,8,7330,7430,100,https://audio-cdn.tarteel.ai/quran/abdulBasitMurattal/001007.mp3
1,Al-Fatiha,7,Abdul Basit,9,7840,13120,5280,https://audio-cdn.tarteel.ai/quran/abdulBasitMurattal/001007.mp3
82,Al-Infitar,1,Abdul Basit,1,0,840,840,https://audio-cdn.tarteel.ai/quran/abdulBasitMurattal/082001.mp3
82,Al-Infitar,1,Abdul Basit,2,1160,2960,1800,https://audio-cdn.tarteel.ai/quran/abdulBasitMurattal/082001.mp3
82,Al-Infitar,1,Abdul Basit,3,3280,5520,2240,https://audio-cdn.tarteel.ai/quran/abdulBasitMurattal/082001.mp3
82,Al-Infitar,2,Abdul Basit,1,0,880,880,https://audio-cdn.tarteel.ai/quran/abdulBasitMurattal/082002.mp3
82,Al-Infitar,2,Abdul Basit,2,1000,2280,1280,https://audio-cdn.tarteel.ai/quran/abdulBasitMurattal/082002.mp3
82,Al-Infitar,2,Abdul Basit,3,2560,5120,2560,https://audio-cdn.tarteel.ai/quran/abdulBasitMurattal/082002.mp3
82,Al-Infitar,3,Abdul Basit,1,0,720,720,https://audio-cdn.tarteel.ai/quran/abdulBasitMurattal/082003.mp3
82,Al-Infitar,3,Abdul Basit,2,880,1800,920,https://audio-cdn.tarteel.ai/quran/abdulBasitMurattal/082003.mp3
82,Al-Infitar,3,Abdul Basit,3,1920,3920,2000,https://audio-cdn.tarteel.ai/quran/abdulBasitMurattal/082003.mp3
82,Al-Infitar,4,Abdul Basit,1,0,720,720,https://audio-cdn.tarteel.ai/quran/abdulBasitMurattal/082004.mp3
82,Al-Infitar,4,Abdul Basit,2,1040,1800,760,https://audio-cdn.tarteel.ai/quran/abdulBasitMurattal/082004.mp3
82,Al-Infitar,4,Abdul Basit,3,1880,3920,2040,https://audio-cdn.tarteel.ai/quran/abdulBasitMurattal/082004.mp3
82,Al-Infitar,5,Abdul Basit,1,0,920,920,https://audio-cdn.tarteel.ai/quran/abdulBasitMurattal/082005.mp3
82,Al-Infitar,5,Abdul Basit,2,1520,1720,200,https://audio-cdn.tarteel.ai/quran/abdulBasitMurattal/082005.mp3
82,Al-Infitar,5,Abdul Basit,3,2410,2510,100,https://audio-cdn.tarteel.ai/quran/abdulBasitMurattal/082005.mp3
82,Al-Infitar,5,Abdul Basit,4,3080,4200,1120,https://audio-cdn.tarteel.ai/quran/abdulBasitMurattal/082005.mp3
82,Al-Infitar,5,Abdul Basit,5,4400,6480,2080,https://audio-cdn.tarteel.ai/quran/abdulBasitMurattal/082005.mp3
82,Al-Infitar,6,Abdul Basit,1,0,70,70,https://audio-cdn.tarteel.ai/quran/abdulBasitMurattal/082006.mp3
82,Al-Infitar,6,Abdul Basit,2,40,2680,2640,https://audio-cdn.tarteel.ai/quran/abdulBasitMurattal/082006.mp3
82,Al-Infitar,6,Abdul Basit,3,3080,4640,1560,https://audio-cdn.tarteel.ai/quran/abdulBasitMurattal/082006.mp3
82,Al-Infitar,6,Abdul Basit,4,4810,4910,100,https://audio-cdn.tarteel.ai/quran/abdulBasitMurattal/082006.mp3
82,Al-Infitar,6,Abdul Basit,5,5160,5960,800,https://audio-cdn.tarteel.ai/quran/abdulBasitMurattal/082006.mp3
82,Al-Infitar,6,Abdul Basit,6,6160,7040,880,https://audio-cdn.tarteel.ai/quran/abdulBasitMurattal/082006.mp3
82,Al-Infitar,6,Abdul Basit,7,7240,8960,1720,https://audio-cdn.tarteel.ai/quran/abdulBasitMurattal/082006.mp3
82,Al-Infitar,7,Abdul Basit,1,0,70,70,https://audio-cdn.tarteel.ai/quran/abdulBasitMurattal/082007.mp3
82,Al-Infitar,7,Abdul Basit,2,1880,2680,800,https://audio-cdn.tarteel.ai/quran/abdulBasitMurattal/082007.mp3
82,Al-Infitar,7,Abdul Basit,3,2880,4040,1160,https://audio-cdn.tarteel.ai/quran/abdulBasitMurattal/082007.mp3
82,Al-Infitar,7,Abdul Basit,4,4280,6040,1760,https://audio-cdn.tarteel.ai/quran/abdulBasitMurattal/082007.mp3
82,Al-Infitar,8,Abdul Basit,1,0,70,70,https://audio-cdn.tarteel.ai/quran/abdulBasitMurattal/082008.mp3
82,Al-Infitar,8,Abdul Basit,2,1600,1760,160,https://audio-cdn.tarteel.ai/quran/abdulBasitMurattal/082008.mp3
82,Al-Infitar,8,Abdul Basit,3,2440,3280,840,https://audio-cdn.tarteel.ai/quran/abdulBasitMurattal/082008.mp3
82,Al-Infitar,8,Abdul Basit,4,4130,4230,100,https://audio-cdn.tarteel.ai/quran/abdulBasitMurattal/082008.mp3
82,Al-Infitar,8,Abdul Basit,5,4800,5040,240,https://audio-cdn.tarteel.ai/quran/abdulBasitMurattal/082008.mp3
82,Al-Infitar,8,Abdul Basit,6,6400,8200,1800,https://audio-cdn.tarteel.ai/quran/abdulBasitMurattal/082008.mp3
82,Al-Infitar,9,Abdul Basit,1,0,1080,1080,https://audio-cdn.tarteel.ai/quran/abdulBasitMurattal/082009.mp3
82,Al-Infitar,9,Abdul Basit,2,1330,1430,100,https://audio-cdn.tarteel.ai/quran/abdulBasitMurattal/082009.mp3
82,Al-Infitar,9,Abdul Basit,3,2160,3000,840,https://audio-cdn.tarteel.ai/quran/abdulBasitMurattal/082009.mp3
82,Al-Infitar,9,Abdul Basit,4,3480,5280,1800,https://audio-cdn.tarteel.ai/quran/abdulBasitMurattal/082009.mp3
82,Al-Infitar,10,Abdul Basit,1,0,70,70,https://audio-cdn.tarteel.ai/quran/abdulBasitMurattal/082010.mp3
82,Al-Infitar,10,Abdul Basit,2,2280,2720,440,https://audio-cdn.tarteel.ai/quran/abdulBasitMurattal/082010.mp3
82,Al-Infitar,10,Abdul Basit,3,3080,5400,2320,https://audio-cdn.tarteel.ai/quran/abdulBasitMurattal/082010.mp3
82,Al-Infitar,11,Abdul Basit,1,0,920,920,https://audio-cdn.tarteel.ai/quran/abdulBasitMurattal/082011.mp3
82,Al-Infitar,11,Abdul Basit,2,1520,3800,2280,https://audio-cdn.tarteel.ai/quran/abdulBasitMurattal/082011.mp3
82,Al-Infitar,12,Abdul Basit,1,1530,1630,100,https://audio-cdn.tarteel.ai/quran/abdulBasitMurattal/082012.mp3
82,Al-Infitar,12,Abdul Basit,2,1970,2070,100,https://audio-cdn.tarteel.ai/quran/abdulBasitMurattal/082012.mp3
82,Al-Infitar,12,Abdul Basit,3,2400,4400,2000,https://audio-cdn.tarteel.ai/quran/abdulBasitMurattal/082012.mp3
82,Al-Infitar,13,Abdul Basit,1,0,70,70,https://audio-cdn.tarteel.ai/quran/abdulBasitMurattal/082013.mp3
82,Al-Infitar,13,Abdul Basit,2,2160,3120,960,https://audio-cdn.tarteel.ai/quran/abdulBasitMurattal/082013.mp3
82,Al-Infitar,13,Abdul Basit,3,3240,3520,280,https://audio-cdn.tarteel.ai/quran/abdulBasitMurattal/082013.mp3
82,Al-Infitar,13,Abdul Basit,4,3880,5280,1400,https://audio-cdn.tarteel.ai/quran/abdulBasitMurattal/082013.mp3
82,Al-Infitar,14,Abdul Basit,1,0,70,70,https://audio-cdn.tarteel.ai/quran/abdulBasitMurattal/082014.mp3
82,Al-Infitar,14,Abdul Basit,2,2480,3400,920,https://audio-cdn.tarteel.ai/quran/abdulBasitMurattal/082014.mp3
82,Al-Infitar,14,Abdul Basit,3,3600,3880,280,https://audio-cdn.tarteel.ai/quran/abdulBasitMurattal/082014.mp3
82,Al-Infitar,14,Abdul Basit,4,4280,5800,1520,https://audio-cdn.tarteel.ai/quran/abdulBasitMurattal/082014.mp3
82,Al-Infitar,15,Abdul Basit,1,0,1680,1680,https://audio-cdn.tarteel.ai/quran/abdulBasitMurattal/082015.mp3
82,Al-Infitar,15,Abdul Basit,2,2009,2109,100,https://audio-cdn.tarteel.ai/quran/abdulBasitMurattal/082015.mp3
82,Al-Infitar,15,Abdul Basit,3,3040,4440,1400,https://audio-cdn.tarteel.ai/quran/abdulBasitMurattal/082015.mp3
82,Al-Infitar,16,Abdul Basit,1,0,70,70,https://audio-cdn.tarteel.ai/quran/abdulBasitMurattal/082016.mp3
82,Al-Infitar,16,Abdul Basit,2,1440,1560,120,https://audio-cdn.tarteel.ai/quran/abdulBasitMurattal/082016.mp3
82,Al-Infitar,16,Abdul Basit,3,1960,2480,520,https://audio-cdn.tarteel.ai/quran/abdulBasitMurattal/082016.mp3
82,Al-Infitar,16,Abdul Basit,4,2840,6360,3520,https://audio-cdn.tarteel.ai/quran/abdulBasitMurattal/082016.mp3
82,Al-Infitar,17,Abdul Basit,1,0,70,70,https://audio-cdn.tarteel.ai/quran/abdulBasitMurattal/082017.mp3
82,Al-Infitar,17,Abdul Basit,2,2560,3240,680,https://audio-cdn.tarteel.ai/quran/abdulBasitMurattal/082017.mp3
82,Al-Infitar,17,Abdul Basit,3,3410,3510,100,https://audio-cdn.tarteel.ai/quran/abdulBasitMurattal/082017.mp3
82,Al-Infitar,17,Abdul Basit,4,3840,4400,560,https://audio-cdn.tarteel.ai/quran/abdulBasitMurattal/082017.mp3
82,Al-Infitar,17,Abdul Basit,5,4800,6040,1240,https://audio-cdn.tarteel.ai/quran/abdulBasitMurattal/082017.mp3
82,Al-Infitar,18,Abdul Basit,1,0,1840,1840,https://audio-cdn.tarteel.ai/quran/abdulBasitMurattal/082018.mp3
82,Al-Infitar,18,Abdul Basit,2,2090,2190,100,https://audio-cdn.tarteel.ai/quran/abdulBasitMurattal/082018.mp3
82,Al-Infitar,18,Abdul Basit,3,3960,4640,680,https://audio-cdn.tarteel.ai/quran/abdulBasitMurattal/082018.mp3
82,Al-Infitar,18,Abdul Basit,4,4850,4950,100,https://audio-cdn.tarteel.ai/quran/abdulBasitMurattal/082018.mp3
82,Al-Infitar,18,Abdul Basit,5,5240,5800,560,https://audio-cdn.tarteel.ai/quran/abdulBasitMurattal/082018.mp3
82,Al-Infitar,18,Abdul Basit,6,6200,7480,1280,https://audio-cdn.tarteel.ai/quran/abdulBasitMurattal/082018.mp3
82,Al-Infitar,19,Abdul Basit,1,0,70,70,https://audio-cdn.tarteel.ai/quran/abdulBasitMurattal/082019.mp3
82,Al-Infitar,19,Abdul Basit,2,1170,1270,100,https://audio-cdn.tarteel.ai/quran/abdulBasitMurattal/082019.mp3
82,Al-Infitar,19,Abdul Basit,3,1520,2440,920,https://audio-cdn.tarteel.ai/quran/abdulBasitMurattal/082019.mp3
82,Al-Infitar,19,Abdul Basit,4,2960,3120,160,https://audio-cdn.tarteel.ai/quran/abdulBasitMurattal/082019.mp3
82,Al-Infitar,19,Abdul Basit,5,3400,4160,760,https://audio-cdn.tarteel.ai/quran/abdulBasitMurattal/082019.mp3
82,Al-Infitar,19,Abdul Basit,6,5050,5150,100,https://audio-cdn.tarteel.ai/quran/abdulBasitMurattal/082019.mp3
82,Al-Infitar,19,Abdul Basit,7,7000,7960,960,https://audio-cdn.tarteel.ai/quran/abdulBasitMurattal/082019.mp3
82,Al-Infitar,19,Abdul Basit,8,8119,9119,1000,https://audio-cdn.tarteel.ai/quran/abdulBasitMurattal/082019.mp3
82,Al-Infitar,19,Abdul Basit,9,9890,9990,100,https://audio-cdn.tarteel.ai/quran/abdulBasitMurattal/082019.mp3
109,Al-Kafirun,1,Abdul Basit,1,0,70,70,https://audio-cdn.tarteel.ai/quran/abdulBasitMurattal/109001.mp3
109,Al-Kafirun,1,Abdul Basit,2,1210,1310,100,https://audio-cdn.tarteel.ai/quran/abdulBasitMurattal/109001.mp3
109,Al-Kafirun,1,Abdul Basit,3,1280,3440,2160,https://audio-cdn.tarteel.ai/quran/abdulBasitMurattal/109001.mp3
109,Al-Kafirun,1,Abdul Basit,4,3640,5800,2160,https://audio-cdn.tarteel.ai/quran/abdulBasitMurattal/109001.mp3
109,Al-Kafirun,2,Abdul Basit,1,0,70,70,https://audio-cdn.tarteel.ai/quran/abdulBasitMurattal/109002.mp3
109,Al-Kafirun,2,Abdul Basit,2,1400,2360,960,https://audio-cdn.tarteel.ai/quran/abdulBasitMurattal/109002.mp3
109,Al-Kafirun,2,Abdul Basit,3,2370,2470,100,https://audio-cdn.tarteel.ai/quran/abdulBasitMurattal/109002.mp3
109,Al-Kafirun,2,Abdul Basit,4,2760,4680,1920,https://audio-cdn.tarteel.ai/quran/abdulBasitMurattal/109002.mp3
109,Al-Kafirun,3,Abdul Basit,1,0,70,70,https://audio-cdn.tarteel.ai/quran/abdulBasitMurattal/109003.mp3
109,Al-Kafirun,3,Abdul Basit,2,2320,3320,1000,https://audio-cdn.tarteel.ai/quran/abdulBasitMurattal/109003.mp3
109,Al-Kafirun,3,Abdul Basit,3,3880,4800,920,https://audio-cdn.tarteel.ai/quran/abdulBasitMurattal/109003.mp3
109,Al-Kafirun,3,Abdul Basit,4,5210,5310,100,https://audio-cdn.tarteel.ai/quran/abdulBasitMurattal/109003.mp3
109,Al-Kafirun,3,Abdul Basit,5,6360,7840,1480,https://audio-cdn.tarteel.ai/quran/abdulBasitMurattal/109003.mp3
109,Al-Kafirun,4,Abdul Basit,1,0,70,70,https://audio-cdn.tarteel.ai/quran/abdulBasitMurattal/109004.mp3
109,Al-Kafirun,4,Abdul Basit,2,1960,2400,440,https://audio-cdn.tarteel.ai/quran/abdulBasitMurattal/109004.mp3
109,Al-Kafirun,4,Abdul Basit,3,2560,3320,760,https://audio-cdn.tarteel.ai/quran/abdulBasitMurattal/109004.mp3
109,Al-Kafirun,4,Abdul Basit,4,4050,4150,100,https://audio-cdn.tarteel.ai/quran/abdulBasitMurattal/109004.mp3
109,Al-Kafirun,4,Abdul Basit,5,4680,5520,840,https://audio-cdn.tarteel.ai/quran/abdulBasitMurattal/109004.mp3
109,Al-Kafirun,5,Abdul Basit,1,0,70,70,https://audio-cdn.tarteel.ai/quran/abdulBasitMurattal/109005.mp3
109,Al-Kafirun,5,Abdul Basit,2,2240,3320,1080,https://audio-cdn.tarteel.ai/quran/abdulBasitMurattal/109005.mp3
109,Al-Kafirun,5,Abdul Basit,3,3920,4800,880,https://audio-cdn.tarteel.ai/quran/abdulBasitMurattal/109005.mp3
109,Al-Kafirun,5,Abdul Basit,4,5210,5310,100,https://audio-cdn.tarteel.ai/quran/abdulBasitMurattal/109005.mp3
109,Al-Kafirun,5,Abdul Basit,5,6280,7720,1440,https://audio-cdn.tarteel.ai/quran/abdulBasitMurattal/109005.mp3
109,Al-Kafirun,6,Abdul Basit,1,0,720,720,https://audio-cdn.tarteel.ai/quran/abdulBasitMurattal/109006.mp3
109,Al-Kafirun,6,Abdul Basit,2,1080,1800,720,https://audio-cdn.tarteel.ai/quran/abdulBasitMurattal/109006.mp3
109,Al-Kafirun,6,Abdul Basit,3,2080,2680,600,https://audio-cdn.tarteel.ai/quran/abdulBasitMurattal/109006.mp3
109,Al-Kafirun,6,Abdul Basit,4,2840,3880,1040,https://audio-cdn.tarteel.ai/quran/abdulBasitMurattal/109006.mp3
111,Al-Lahab,1,Abdul Basit,1,0,1000,1000,https://audio-cdn.tarteel.ai/quran/abdulBasitMurattal/111001.mp3
111,Al-Lahab,1,Abdul Basit,2,1200,1600,400,https://audio-cdn.tarteel.ai/quran/abdulBasitMurattal/111001.mp3
111,Al-Lahab,1,Abdul Basit,3,2680,3200,520,https://audio-cdn.tarteel.ai/quran/abdulBasitMurattal/111001.mp3
111,Al-Lahab,1,Abdul Basit,4,3520,4080,560,https://audio-cdn.tarteel.ai/quran/abdulBasitMurattal/111001.mp3
111,Al-Lahab,1,Abdul Basit,5,4760,6280,1520,https://audio-cdn.tarteel.ai/quran/abdulBasitMurattal/111001.mp3
111,Al-Lahab,2,Abdul Basit,1,0,70,70,https://audio-cdn.tarteel.ai/quran/abdulBasitMurattal/111002.mp3
111,Al-Lahab,2,Abdul Basit,2,1640,2360,720,https://audio-cdn.tarteel.ai/quran/abdulBasitMurattal/111002.mp3
111,Al-Lahab,2,Abdul Basit,3,3010,3110,100,https://audio-cdn.tarteel.ai/quran/abdulBasitMurattal/111002.mp3
111,Al-Lahab,2,Abdul Basit,4,3280,3960,680,https://audio-cdn.tarteel.ai/quran/abdulBasitMurattal/111002.mp3
111,Al-Lahab,2,Abdul Basit,5,4250,4350,100,https://audio-cdn.tarteel.ai/quran/abdulBasitMurattal/111002.mp3
111,Al-Lahab,2,Abdul Basit,6,4960,6280,1320,https://audio-cdn.tarteel.ai/quran/abdulBasitMurattal/111002.mp3
111,Al-Lahab,3,Abdul Basit,1,0,1560,1560,https://audio-cdn.tarteel.ai/quran/abdulBasitMurattal/111003.mp3
111,Al-Lahab,3,Abdul Basit,2,1880,2440,560,https://audio-cdn.tarteel.ai/quran/abdulBasitMurattal/111003.mp3
111,Al-Lahab,3,Abdul Basit,3,3120,3880,760,https://audio-cdn.tarteel.ai/quran/abdulBasitMurattal/111003.mp3
111,Al-Lahab,3,Abdul Basit,4,4120,5240,1120,https://audio-cdn.tarteel.ai/quran/abdulBasitMurattal/111003.mp3
111,Al-Lahab,4,Abdul Basit,1,0,1520,1520,https://audio-cdn.tarteel.ai/quran/abdulBasitMurattal/111004.mp3
111,Al-Lahab,4,Abdul Basit,2,1840,3680,1840,https://audio-cdn.tarteel.ai/quran/abdulBasitMurattal/111004.mp3
111,Al-Lahab,4,Abdul Basit,3,4040,5200,1160,https://audio-cdn.tarteel.ai/quran/abdulBasitMurattal/111004.mp3
111,Al-Lahab,5,Abdul Basit,1,0,70,70,https://audio-cdn.tarteel.ai/quran/abdulBasitMurattal/111005.mp3
111,Al-Lahab,5,Abdul Basit,2,600,1440,840,https://audio-cdn.tarteel.ai/quran/abdulBasitMurattal/111005.mp3
111,Al-Lahab,5,Abdul Basit,3,1760,2400,640,https://audio-cdn.tarteel.ai/quran/abdulBasitMurattal/111005.mp3
111,Al-Lahab,5,Abdul Basit,4,2970,3070,100,https://audio-cdn.tarteel.ai/quran/abdulBasitMurattal/111005.mp3
111,Al-Lahab,5,Abdul Basit,5,4120,5520,1400,https://audio-cdn.tarteel.ai/quran/abdulBasitMurattal/111005.mp3
112,Al-Ikhlas,1,Abdul Basit,1,0,70,70,https://audio-cdn.tarteel.ai/quran/abdulBasitMurattal/112001.mp3
112,Al-Ikhlas,1,Abdul Basit,2,680,1000,320,https://audio-cdn.tarteel.ai/quran/abdulBasitMurattal/112001.mp3
112,Al-Ikhlas,1,Abdul Basit,3,1250,1350,100,https://audio-cdn.tarteel.ai/quran/abdulBasitMurattal/112001.mp3
112,Al-Ikhlas,1,Abdul Basit,4,2240,3160,920,https://audio-cdn.tarteel.ai/quran/abdulBasitMurattal/112001.mp3
112,Al-Ikhlas,2,Abdul Basit,1,650,750,100,https://audio-cdn.tarteel.ai/quran/abdulBasitMurattal/112002.mp3
112,Al-Ikhlas,2,Abdul Basit,2,1560,2840,1280,https://audio-cdn.tarteel.ai/quran/abdulBasitMurattal/112002.mp3
112,Al-Ikhlas,3,Abdul Basit,1,0,600,600,https://audio-cdn.tarteel.ai/quran/abdulBasitMurattal/112003.mp3
112,Al-Ikhlas,3,Abdul Basit,2,720,1320,600,https://audio-cdn.tarteel.ai/quran/abdulBasitMurattal/112003.mp3
112,Al-Ikhlas,3,Abdul Basit,3,1400,1880,480,https://audio-cdn.tarteel.ai/quran/abdulBasitMurattal/112003.mp3
112,Al-Ikhlas,3,Abdul Basit,4,2040,3440,1400,https://audio-cdn.tarteel.ai/quran/abdulBasitMurattal/112003.mp3
112,Al-Ikhlas,4,Abdul Basit,1,0,680,680,https://audio-cdn.tarteel.ai/quran/abdulBasitMurattal/112004.mp3
112,Al-Ikhlas,4,Abdul Basit,2,800,1120,320,https://audio-cdn.tarteel.ai/quran/abdulBasitMurattal/112004.mp3
112,Al-Ikhlas,4,Abdul Basit,3,1690,1790,100,https://audio-cdn.tarteel.ai/quran/abdulBasitMurattal/112004.mp3
112,Al-Ikhlas,4,Abdul Basit,4,2080,2680,600,https://audio-cdn.tarteel.ai/quran/abdulBasitMurattal/112004.mp3
112,Al-Ikhlas,4,Abdul Basit,5,3280,4240,960,https://audio-cdn.tarteel.ai/quran/abdulBasitMurattal/112004.mp3
113,Al-Falaq,1,Abdul Basit,1,0,70,70,https://audio-cdn.tarteel.ai/quran/abdulBasitMurattal/113001.mp3
113,Al-Falaq,1,Abdul Basit,2,1080,1840,760,https://audio-cdn.tarteel.ai/quran/abdulBasitMurattal/113001.mp3
113,Al-Falaq,1,Abdul Basit,3,1890,1990,100,https://audio-cdn.tarteel.ai/quran/abdulBasitMurattal/113001.mp3
113,Al-Falaq,1,Abdul Basit,4,2960,4200,1240,https://audio-cdn.tarteel.ai/quran/abdulBasitMurattal/113001.mp3
113,Al-Falaq,2,Abdul Basit,1,0,70,70,https://audio-cdn.tarteel.ai/quran/abdulBasitMurattal/113002.mp3
113,Al-Falaq,2,Abdul Basit,2,1120,1800,680,https://audio-cdn.tarteel.ai/quran/abdulBasitMurattal/113002.mp3
113,Al-Falaq,2,Abdul Basit,3,1970,2070,100,https://audio-cdn.tarteel.ai/quran/abdulBasitMurattal/113002.mp3
113,Al-Falaq,2,Abdul Basit,4,2290,2390,100,https://audio-cdn.tarteel.ai/quran/abdulBasitMurattal/113002.mp3
113,Al-Falaq,3,Abdul Basit,1,0,70,70,https://audio-cdn.tarteel.ai/quran/abdulBasitMurattal/113003.mp3
113,Al-Falaq,3,Abdul Basit,2,1480,2160,680,https://audio-cdn.tarteel.ai/quran/abdulBasitMurattal/113003.mp3
113,Al-Falaq,3,Abdul Basit,3,2360,3080,720,https://audio-cdn.tarteel.ai/quran/abdulBasitMurattal/113003.mp3
113,Al-Falaq,3,Abdul Basit,4,3600,3760,160,https://audio-cdn.tarteel.ai/quran/abdulBasitMurattal/113003.mp3
113,Al-Falaq,3,Abdul Basit,5,4000,5240,1240,https://audio-cdn.tarteel.ai/quran/abdulBasitMurattal/113003.mp3
113,Al-Falaq,4,Abdul Basit,1,0,70,70,https://audio-cdn.tarteel.ai/quran/abdulBasitMurattal/113004.mp3
113,Al-Falaq,4,Abdul Basit,2,1440,2160,720,https://audio-cdn.tarteel.ai/quran/abdulBasitMurattal/113004.mp3
113,Al-Falaq,4,Abdul Basit,3,2840,4280,1440,https://audio-cdn.tarteel.ai/quran/abdulBasitMurattal/113004.mp3
113,Al-Falaq,4,Abdul Basit,4,4490,4590,100,https://audio-cdn.tarteel.ai/quran/abdulBasitMurattal/113004.mp3
113,Al-Falaq,4,Abdul Basit,5,4720,6160,1440,https://audio-cdn.tarteel.ai/quran/abdulBasitMurattal/113004.mp3
113,Al-Falaq,5,Abdul Basit,1,0,70,70,https://audio-cdn.tarteel.ai/quran/abdulBasitMurattal/113005.mp3
113,Al-Falaq,5,Abdul Basit,2,1480,2160,680,https://audio-cdn.tarteel.ai/quran/abdulBasitMurattal/113005.mp3
113,Al-Falaq,5,Abdul Basit,3,2320,3080,760,https://audio-cdn.tarteel.ai/quran/abdulBasitMurattal/113005.mp3
113,Al-Falaq,5,Abdul Basit,4,3560,3720,160,https://audio-cdn.tarteel.ai/quran/abdulBasitMurattal/113005.mp3
113,Al-Falaq,5,Abdul Basit,5,3920,5160,1240,https://audio-cdn.tarteel.ai/quran/abdulBasitMurattal/113005.mp3
