surah_number,surah_name,ayah_number,reciter,word_number,start_time_ms,end_time_ms,duration_ms,audio_url
1,Al-Fatiha,1,Husary,1,0,480,480,https://audio-cdn.tarteel.ai/quran/husary/001001.mp3
1,Al-Fatiha,1,Husary,2,600,1000,400,https://audio-cdn.tarteel.ai/quran/husary/001001.mp3
1,Al-Fatiha,1,Husary,3,1800,2160,360,https://audio-cdn.tarteel.ai/quran/husary/001001.mp3
1,Al-Fatiha,1,Husary,4,2480,5160,2680,https://audio-cdn.tarteel.ai/quran/husary/001001.mp3
1,Al-Fatiha,2,Husary,1,800,1240,440,https://audio-cdn.tarteel.ai/quran/husary/001002.mp3
1,Al-Fatiha,2,Husary,2,1570,1670,100,https://audio-cdn.tarteel.ai/quran/husary/001002.mp3
1,Al-Fatiha,2,Husary,3,2530,2630,100,https://audio-cdn.tarteel.ai/quran/husary/001002.mp3
1,Al-Fatiha,2,Husary,4,2800,6240,3440,https://audio-cdn.tarteel.ai/quran/husary/001002.mp3
1,Al-Fatiha,3,Husary,1,800,1200,400,https://audio-cdn.tarteel.ai/quran/husary/001003.mp3
1,Al-Fatiha,3,Husary,2,1520,4480,2960,https://audio-cdn.tarteel.ai/quran/husary/001003.mp3
1,Al-Fatiha,4,Husary,1,0,720,720,https://audio-cdn.tarteel.ai/quran/husary/001004.mp3
1,Al-Fatiha,4,Husary,2,920,1440,520,https://audio-cdn.tarteel.ai/quran/husary/001004.mp3
1,Al-Fatiha,4,Husary,3,1840,4600,2760,https://audio-cdn.tarteel.ai/quran/husary/001004.mp3
1,Al-Fatiha,5,Husary,1,0,1000,1000,https://audio-cdn.tarteel.ai/quran/husary/001005.mp3
1,Al-Fatiha,5,Husary,2,1200,2000,800,https://audio-cdn.tarteel.ai/quran/husary/001005.mp3
1,Al-Fatiha,5,Husary,3,2080,3160,1080,https://audio-cdn.tarteel.ai/quran/husary/001005.mp3
1,Al-Fatiha,5,Husary,4,3400,6800,3400,https://audio-cdn.tarteel.ai/quran/husary/001005.mp3
1,Al-Fatiha,6,Husary,1,0,680,680,https://audio-cdn.tarteel.ai/quran/husary/001006.mp3
1,Al-Fatiha,6,Husary,2,1000,1640,640,https://audio-cdn.tarteel.ai/quran/husary/001006.mp3
1,Al-Fatiha,6,Husary,3,2040,5320,3280,https://audio-cdn.tarteel.ai/quran/husary/001006.mp3
1,Al-Fatiha,7,Husary,1,0,960,960,https://audio-cdn.tarteel.ai/quran/husary/001007.mp3
1,Al-Fatiha,7,Husary,2,1240,1640,400,https://audio-cdn.tarteel.ai/quran/husary/001007.mp3
1,Al-Fatiha,7,Husary,3,2000,2840,840,https://audio-cdn.tarteel.ai/quran/husary/001007.mp3
1,Al-Fatiha,7,Husary,4,3320,3720,400,https://audio-cdn.tarteel.ai/quran/husary/001007.mp3
1,Al-Fatiha,7,Husary,5,4000,4120,120,https://audio-cdn.tarteel.ai/quran/husary/001007.mp3
1,Al-Fatiha,7,Husary,6,5040,6000,960,https://audio-cdn.tarteel.ai/quran/husary/001007.mp3
1,Al-Fatiha,7,Husary,7,6440,6880,440,https://audio-cdn.tarteel.ai/quran/husary/001007.mp3
1,Al-Fatiha,7,Husary,8,7170,7270,100,https://audio-cdn.tarteel.ai/quran/husary/001007.mp3
1,Al-Fatiha,7,Husary,9,7720,14920,7200,https://audio-cdn.tarteel.ai/quran/husary/001007.mp3
82,Al-Infitar,1,Husary,1,0,840,840,https://audio-cdn.tarteel.ai/quran/husary/082001.mp3
82,Al-Infitar,1,Husary,2,1320,3760,2440,https://audio-cdn.tarteel.ai/quran/husary/082001.mp3
82,Al-Infitar,1,Husary,3,4120,7360,3240,https://audio-cdn.tarteel.ai/quran/husary/082001.mp3
82,Al-Infitar,2,Husary,1,0,840,840,https://audio-cdn.tarteel.ai/quran/husary/082002.mp3
82,Al-Infitar,2,Husary,2,1080,2880,1800,https://audio-cdn.tarteel.ai/quran/husary/082002.mp3
82,Al-Infitar,2,Husary,3,3200,6400,3200,https://audio-cdn.tarteel.ai/quran/husary/082002.mp3
82,Al-Infitar,3,Husary,1,0,960,960,https://audio-cdn.tarteel.ai/quran/husary/082003.mp3
82,Al-Infitar,3,Husary,2,1200,2480,1280,https://audio-cdn.tarteel.ai/quran/husary/082003.mp3
82,Al-Infitar,3,Husary,3,2760,5720,2960,https://audio-cdn.tarteel.ai/quran/husary/082003.mp3
82,Al-Infitar,4,Husary,1,0,760,760,https://audio-cdn.tarteel.ai/quran/husary/082004.mp3
82,Al-Infitar,4,Husary,2,1280,2320,1040,https://audio-cdn.tarteel.ai/quran/husary/082004.mp3
82,Al-Infitar,4,Husary,3,2520,5360,2840,https://audio-cdn.tarteel.ai/quran/husary/082004.mp3
82,Al-Infitar,5,Husary,1,0,1240,1240,https://audio-cdn.tarteel.ai/quran/husary/082005.mp3
82,Al-Infitar,5,Husary,2,2120,2320,200,https://audio-cdn.tarteel.ai/quran/husary/082005.mp3
82,Al-Infitar,5,Husary,3,3090,3190,100,https://audio-cdn.tarteel.ai/quran/husary/082005.mp3
82,Al-Infitar,5,Husary,4,3840,5440,1600,https://audio-cdn.tarteel.ai/quran/husary/082005.mp3
82,Al-Infitar,5,Husary,5,5720,8640,2920,https://audio-cdn.tarteel.ai/quran/husary/082005.mp3
82,Al-Infitar,6,Husary,1,0,70,70,https://audio-cdn.tarteel.ai/quran/husary/082006.mp3
82,Al-Infitar,6,Husary,2,40,3000,2960,https://audio-cdn.tarteel.ai/quran/husary/082006.mp3
82,Al-Infitar,6,Husary,3,3640,5600,1960,https://audio-cdn.tarteel.ai/quran/husary/082006.mp3
82,Al-Infitar,6,Husary,4,5850,5950,100,https://audio-cdn.tarteel.ai/quran/husary/082006.mp3
82,Al-Infitar,6,Husary,5,6560,7840,1280,https://audio-cdn.tarteel.ai/quran/husary/082006.mp3
82,Al-Infitar,6,Husary,6,8160,9560,1400,https://audio-cdn.tarteel.ai/quran/husary/082006.mp3
82,Al-Infitar,6,Husary,7,9920,13640,3720,https://audio-cdn.tarteel.ai/quran/husary/082006.mp3
82,Al-Infitar,7,Husary,1,0,70,70,https://audio-cdn.tarteel.ai/quran/husary/082007.mp3
82,Al-Infitar,7,Husary,2,2040,3200,1160,https://audio-cdn.tarteel.ai/quran/husary/082007.mp3
82,Al-Infitar,7,Husary,3,3480,5280,1800,https://audio-cdn.tarteel.ai/quran/husary/082007.mp3
82,Al-Infitar,7,Husary,4,5640,8480,2840,https://audio-cdn.tarteel.ai/quran/husary/082007.mp3
82,Al-Infitar,8,Husary,1,0,70,70,https://audio-cdn.tarteel.ai/quran/husary/082008.mp3
82,Al-Infitar,8,Husary,2,1560,1720,160,https://audio-cdn.tarteel.ai/quran/husary/082008.mp3
82,Al-Infitar,8,Husary,3,2720,4040,1320,https://audio-cdn.tarteel.ai/quran/husary/082008.mp3
82,Al-Infitar,8,Husary,4,4970,5070,100,https://audio-cdn.tarteel.ai/quran/husary/082008.mp3
82,Al-Infitar,8,Husary,5,5840,6120,280,https://audio-cdn.tarteel.ai/quran/husary/082008.mp3
82,Al-Infitar,8,Husary,6,8039,10799,2760,https://audio-cdn.tarteel.ai/quran/husary/082008.mp3
82,Al-Infitar,9,Husary,1,0,1080,1080,https://audio-cdn.tarteel.ai/quran/husary/082009.mp3
82,Al-Infitar,9,Husary,2,1610,1710,100,https://audio-cdn.tarteel.ai/quran/husary/082009.mp3
82,Al-Infitar,9,Husary,3,2720,3880,1160,https://audio-cdn.tarteel.ai/quran/husary/082009.mp3
82,Al-Infitar,9,Husary,4,4720,8240,3520,https://audio-cdn.tarteel.ai/quran/husary/082009.mp3
82,Al-Infitar,10,Husary,1,0,70,70,https://audio-cdn.tarteel.ai/quran/husary/082010.mp3
82,Al-Infitar,10,Husary,2,2120,2760,640,https://audio-cdn.tarteel.ai/quran/husary/082010.mp3
82,Al-Infitar,10,Husary,3,3360,9120,5760,https://audio-cdn.tarteel.ai/quran/husary/082010.mp3
82,Al-Infitar,11,Husary,1,0,1160,1160,https://audio-cdn.tarteel.ai/quran/husary/082011.mp3
82,Al-Infitar,11,Husary,2,2040,6040,4000,https://audio-cdn.tarteel.ai/quran/husary/082011.mp3
82,Al-Infitar,12,Husary,1,1650,1750,100,https://audio-cdn.tarteel.ai/quran/husary/082012.mp3
82,Al-Infitar,12,Husary,2,2370,2470,100,https://audio-cdn.tarteel.ai/quran/husary/082012.mp3
82,Al-Infitar,12,Husary,3,3040,8080,5040,https://audio-cdn.tarteel.ai/quran/husary/082012.mp3
82,Al-Infitar,13,Husary,1,0,70,70,https://audio-cdn.tarteel.ai/quran/husary/082013.mp3
82,Al-Infitar,13,Husary,2,1840,3240,1400,https://audio-cdn.tarteel.ai/quran/husary/082013.mp3
82,Al-Infitar,13,Husary,3,3520,3920,400,https://audio-cdn.tarteel.ai/quran/husary/082013.mp3
82,Al-Infitar,13,Husary,4,4560,7760,3200,https://audio-cdn.tarteel.ai/quran/husary/082013.mp3
82,Al-Infitar,14,Husary,1,0,70,70,https://audio-cdn.tarteel.ai/quran/husary/082014.mp3
82,Al-Infitar,14,Husary,2,2200,3720,1520,https://audio-cdn.tarteel.ai/quran/husary/082014.mp3
82,Al-Infitar,14,Husary,3,4120,4520,400,https://audio-cdn.tarteel.ai/quran/husary/082014.mp3
82,Al-Infitar,14,Husary,4,5200,8280,3080,https://audio-cdn.tarteel.ai/quran/husary/082014.mp3
82,Al-Infitar,15,Husary,1,0,2080,2080,https://audio-cdn.tarteel.ai/quran/husary/082015.mp3
82,Al-Infitar,15,Husary,2,2730,2830,100,https://audio-cdn.tarteel.ai/quran/husary/082015.mp3
82,Al-Infitar,15,Husary,3,4440,7240,2800,https://audio-cdn.tarteel.ai/quran/husary/082015.mp3
82,Al-Infitar,16,Husary,1,0,70,70,https://audio-cdn.tarteel.ai/quran/husary/082016.mp3
82,Al-Infitar,16,Husary,2,1280,1400,120,https://audio-cdn.tarteel.ai/quran/husary/082016.mp3
82,Al-Infitar,16,Husary,3,2080,2920,840,https://audio-cdn.tarteel.ai/quran/husary/082016.mp3
82,Al-Infitar,16,Husary,4,3760,10560,6800,https://audio-cdn.tarteel.ai/quran/husary/082016.mp3
82,Al-Infitar,17,Husary,1,0,70,70,https://audio-cdn.tarteel.ai/quran/husary/082017.mp3
82,Al-Infitar,17,Husary,2,2600,3680,1080,https://audio-cdn.tarteel.ai/quran/husary/082017.mp3
82,Al-Infitar,17,Husary,3,4050,4150,100,https://audio-cdn.tarteel.ai/quran/husary/082017.mp3
82,Al-Infitar,17,Husary,4,4760,5680,920,https://audio-cdn.tarteel.ai/quran/husary/082017.mp3
82,Al-Infitar,17,Husary,5,6360,9520,3160,https://audio-cdn.tarteel.ai/quran/husary/082017.mp3
82,Al-Infitar,18,Husary,1,0,1160,1160,https://audio-cdn.tarteel.ai/quran/husary/082018.mp3
82,Al-Infitar,18,Husary,2,1410,1510,100,https://audio-cdn.tarteel.ai/quran/husary/082018.mp3
82,Al-Infitar,18,Husary,3,3480,4520,1040,https://audio-cdn.tarteel.ai/quran/husary/082018.mp3
82,Al-Infitar,18,Husary,4,4890,4990,100,https://audio-cdn.tarteel.ai/quran/husary/082018.mp3
82,Al-Infitar,18,Husary,5,5600,6560,960,https://audio-cdn.tarteel.ai/quran/husary/082018.mp3
82,Al-Infitar,18,Husary,6,7240,11400,4160,https://audio-cdn.tarteel.ai/quran/husary/082018.mp3
82,Al-Infitar,19,Husary,1,0,70,70,https://audio-cdn.tarteel.ai/quran/husary/082019.mp3
82,Al-Infitar,19,Husary,2,930,1030,100,https://audio-cdn.tarteel.ai/quran/husary/082019.mp3
82,Al-Infitar,19,Husary,3,1480,2800,1320,https://audio-cdn.tarteel.ai/quran/husary/082019.mp3
82,Al-Infitar,19,Husary,4,3640,3800,160,https://audio-cdn.tarteel.ai/quran/husary/082019.mp3
82,Al-Infitar,19,Husary,5,4360,5520,1160,https://audio-cdn.tarteel.ai/quran/husary/082019.mp3
82,Al-Infitar,19,Husary,6,6650,6750,100,https://audio-cdn.tarteel.ai/quran/husary/082019.mp3
82,Al-Infitar,19,Husary,7,9720,11080,1360,https://audio-cdn.tarteel.ai/quran/husary/082019.mp3
82,Al-Infitar,19,Husary,8,11400,12840,1440,https://audio-cdn.tarteel.ai/quran/husary/082019.mp3
82,Al-Infitar,19,Husary,9,14010,14110,100,https://audio-cdn.tarteel.ai/quran/husary/082019.mp3
109,Al-Kafirun,1,Husary,1,0,70,70,https://audio-cdn.tarteel.ai/quran/husary/109001.mp3
109,Al-Kafirun,1,Husary,2,1510,1610,100,https://audio-cdn.tarteel.ai/quran/husary/109001.mp3
109,Al-Kafirun,1,Husary,3,1600,4400,2800,https://audio-cdn.tarteel.ai/quran/husary/109001.mp3
109,Al-Kafirun,1,Husary,4,4880,9640,4760,https://audio-cdn.tarteel.ai/quran/husary/109001.mp3
109,Al-Kafirun,2,Husary,1,0,70,70,https://audio-cdn.tarteel.ai/quran/husary/109002.mp3
109,Al-Kafirun,2,Husary,2,1920,3280,1360,https://audio-cdn.tarteel.ai/quran/husary/109002.mp3
109,Al-Kafirun,2,Husary,3,3410,3510,100,https://audio-cdn.tarteel.ai/quran/husary/109002.mp3
109,Al-Kafirun,2,Husary,4,4120,7560,3440,https://audio-cdn.tarteel.ai/quran/husary/109002.mp3
109,Al-Kafirun,3,Husary,1,0,70,70,https://audio-cdn.tarteel.ai/quran/husary/109003.mp3
109,Al-Kafirun,3,Husary,2,2120,3280,1160,https://audio-cdn.tarteel.ai/quran/husary/109003.mp3
109,Al-Kafirun,3,Husary,3,4080,5640,1560,https://audio-cdn.tarteel.ai/quran/husary/109003.mp3
109,Al-Kafirun,3,Husary,4,6410,6510,100,https://audio-cdn.tarteel.ai/quran/husary/109003.mp3
109,Al-Kafirun,3,Husary,5,8000,10600,2600,https://audio-cdn.tarteel.ai/quran/husary/109003.mp3
109,Al-Kafirun,4,Husary,1,0,70,70,https://audio-cdn.tarteel.ai/quran/husary/109004.mp3
109,Al-Kafirun,4,Husary,2,2000,2520,520,https://audio-cdn.tarteel.ai/quran/husary/109004.mp3
109,Al-Kafirun,4,Husary,3,2840,4120,1280,https://audio-cdn.tarteel.ai/quran/husary/109004.mp3
109,Al-Kafirun,4,Husary,4,5090,5190,100,https://audio-cdn.tarteel.ai/quran/husary/109004.mp3
109,Al-Kafirun,4,Husary,5,6000,7240,1240,https://audio-cdn.tarteel.ai/quran/husary/109004.mp3
109,Al-Kafirun,5,Husary,1,0,70,70,https://audio-cdn.tarteel.ai/quran/husary/109005.mp3
109,Al-Kafirun,5,Husary,2,1880,3080,1200,https://audio-cdn.tarteel.ai/quran/husary/109005.mp3
109,Al-Kafirun,5,Husary,3,3880,5520,1640,https://audio-cdn.tarteel.ai/quran/husary/109005.mp3
109,Al-Kafirun,5,Husary,4,6410,6510,100,https://audio-cdn.tarteel.ai/quran/husary/109005.mp3
109,Al-Kafirun,5,Husary,5,8080,10200,2120,https://audio-cdn.tarteel.ai/quran/husary/109005.mp3
109,Al-Kafirun,6,Husary,1,0,760,760,https://audio-cdn.tarteel.ai/quran/husary/109006.mp3
109,Al-Kafirun,6,Husary,2,1360,2640,1280,https://audio-cdn.tarteel.ai/quran/husary/109006.mp3
109,Al-Kafirun,6,Husary,3,3280,4280,1000,https://audio-cdn.tarteel.ai/quran/husary/109006.mp3
109,Al-Kafirun,6,Husary,4,4600,7040,2440,https://audio-cdn.tarteel.ai/quran/husary/109006.mp3
111,Al-Lahab,1,Husary,1,0,1960,1960,https://audio-cdn.tarteel.ai/quran/husary/111001.mp3
111,Al-Lahab,1,Husary,2,2240,2760,520,https://audio-cdn.tarteel.ai/quran/husary/111001.mp3
111,Al-Lahab,1,Husary,3,3960,4560,600,https://audio-cdn.tarteel.ai/quran/husary/111001.mp3
111,Al-Lahab,1,Husary,4,5120,6000,880,https://audio-cdn.tarteel.ai/quran/husary/111001.mp3
111,Al-Lahab,1,Husary,5,7040,9600,2560,https://audio-cdn.tarteel.ai/quran/husary/111001.mp3
111,Al-Lahab,2,Husary,1,0,70,70,https://audio-cdn.tarteel.ai/quran/husary/111002.mp3
111,Al-Lahab,2,Husary,2,1960,2960,1000,https://audio-cdn.tarteel.ai/quran/husary/111002.mp3
111,Al-Lahab,2,Husary,3,4410,4510,100,https://audio-cdn.tarteel.ai/quran/husary/111002.mp3
111,Al-Lahab,2,Husary,4,4880,6080,1200,https://audio-cdn.tarteel.ai/quran/husary/111002.mp3
111,Al-Lahab,2,Husary,5,6690,6790,100,https://audio-cdn.tarteel.ai/quran/husary/111002.mp3
111,Al-Lahab,2,Husary,6,7920,10160,2240,https://audio-cdn.tarteel.ai/quran/husary/111002.mp3
111,Al-Lahab,3,Husary,1,0,1560,1560,https://audio-cdn.tarteel.ai/quran/husary/111003.mp3
111,Al-Lahab,3,Husary,2,2200,3120,920,https://audio-cdn.tarteel.ai/quran/husary/111003.mp3
111,Al-Lahab,3,Husary,3,4120,5160,1040,https://audio-cdn.tarteel.ai/quran/husary/111003.mp3
111,Al-Lahab,3,Husary,4,5560,7760,2200,https://audio-cdn.tarteel.ai/quran/husary/111003.mp3
111,Al-Lahab,4,Husary,1,0,1960,1960,https://audio-cdn.tarteel.ai/quran/husary/111004.mp3
111,Al-Lahab,4,Husary,2,2560,4960,2400,https://audio-cdn.tarteel.ai/quran/husary/111004.mp3
111,Al-Lahab,4,Husary,3,5640,7440,1800,https://audio-cdn.tarteel.ai/quran/husary/111004.mp3
111,Al-Lahab,5,Husary,1,0,70,70,https://audio-cdn.tarteel.ai/quran/husary/111005.mp3
111,Al-Lahab,5,Husary,2,880,2240,1360,https://audio-cdn.tarteel.ai/quran/husary/111005.mp3
111,Al-Lahab,5,Husary,3,2840,3840,1000,https://audio-cdn.tarteel.ai/quran/husary/111005.mp3
111,Al-Lahab,5,Husary,4,4850,4950,100,https://audio-cdn.tarteel.ai/quran/husary/111005.mp3
111,Al-Lahab,5,Husary,5,6080,8000,1920,https://audio-cdn.tarteel.ai/quran/husary/111005.mp3
112,Al-Ikhlas,1,Husary,1,0,70,70,https://audio-cdn.tarteel.ai/quran/husary/112001.mp3
112,Al-Ikhlas,1,Husary,2,1200,1680,480,https://audio-cdn.tarteel.ai/quran/husary/112001.mp3
112,Al-Ikhlas,1,Husary,3,2250,2350,100,https://audio-cdn.tarteel.ai/quran/husary/112001.mp3
112,Al-Ikhlas,1,Husary,4,3960,5800,1840,https://audio-cdn.tarteel.ai/quran/husary/112001.mp3
112,Al-Ikhlas,2,Husary,1,1050,1150,100,https://audio-cdn.tarteel.ai/quran/husary/112002.mp3
112,Al-Ikhlas,2,Husary,2,2720,5000,2280,https://audio-cdn.tarteel.ai/quran/husary/112002.mp3
112,Al-Ikhlas,3,Husary,1,0,680,680,https://audio-cdn.tarteel.ai/quran/husary/112003.mp3
112,Al-Ikhlas,3,Husary,2,880,1880,1000,https://audio-cdn.tarteel.ai/quran/husary/112003.mp3
112,Al-Ikhlas,3,Husary,3,2080,3000,920,https://audio-cdn.tarteel.ai/quran/husary/112003.mp3
112,Al-Ikhlas,3,Husary,4,3320,5880,2560,https://audio-cdn.tarteel.ai/quran/husary/112003.mp3
112,Al-Ikhlas,4,Husary,1,0,800,800,https://audio-cdn.tarteel.ai/quran/husary/112004.mp3
112,Al-Ikhlas,4,Husary,2,1040,1600,560,https://audio-cdn.tarteel.ai/quran/husary/112004.mp3
112,Al-Ikhlas,4,Husary,3,2570,2670,100,https://audio-cdn.tarteel.ai/quran/husary/112004.mp3
112,Al-Ikhlas,4,Husary,4,3360,4360,1000,https://audio-cdn.tarteel.ai/quran/husary/112004.mp3
112,Al-Ikhlas,4,Husary,5,5520,8080,2560,https://audio-cdn.tarteel.ai/quran/husary/112004.mp3
113,Al-Falaq,1,Husary,1,0,70,70,https://audio-cdn.tarteel.ai/quran/husary/113001.mp3
113,Al-Falaq,1,Husary,2,1000,2160,1160,https://audio-cdn.tarteel.ai/quran/husary/113001.mp3
113,Al-Falaq,1,Husary,3,2370,2470,100,https://audio-cdn.tarteel.ai/quran/husary/113001.mp3
113,Al-Falaq,1,Husary,4,4280,6280,2000,https://audio-cdn.tarteel.ai/quran/husary/113001.mp3
113,Al-Falaq,2,Husary,1,0,70,70,https://audio-cdn.tarteel.ai/quran/husary/113002.mp3
113,Al-Falaq,2,Husary,2,1240,2240,1000,https://audio-cdn.tarteel.ai/quran/husary/113002.mp3
113,Al-Falaq,2,Husary,3,2530,2630,100,https://audio-cdn.tarteel.ai/quran/husary/113002.mp3
113,Al-Falaq,2,Husary,4,3170,3270,100,https://audio-cdn.tarteel.ai/quran/husary/113002.mp3
113,Al-Falaq,3,Husary,1,0,70,70,https://audio-cdn.tarteel.ai/quran/husary/113003.mp3
113,Al-Falaq,3,Husary,2,1240,2160,920,https://audio-cdn.tarteel.ai/quran/husary/113003.mp3
113,Al-Falaq,3,Husary,3,2520,3920,1400,https://audio-cdn.tarteel.ai/quran/husary/113003.mp3
113,Al-Falaq,3,Husary,4,4920,5080,160,https://audio-cdn.tarteel.ai/quran/husary/113003.mp3
113,Al-Falaq,3,Husary,5,5640,7640,2000,https://audio-cdn.tarteel.ai/quran/husary/113003.mp3
113,Al-Falaq,4,Husary,1,0,70,70,https://audio-cdn.tarteel.ai/quran/husary/113004.mp3
113,Al-Falaq,4,Husary,2,1520,2440,920,https://audio-cdn.tarteel.ai/quran/husary/113004.mp3
113,Al-Falaq,4,Husary,3,3400,5920,2520,https://audio-cdn.tarteel.ai/quran/husary/113004.mp3
113,Al-Falaq,4,Husary,4,6330,6430,100,https://audio-cdn.tarteel.ai/quran/husary/113004.mp3
113,Al-Falaq,4,Husary,5,6760,9200,2440,https://audio-cdn.tarteel.ai/quran/husary/113004.mp3
113,Al-Falaq,5,Husary,1,0,70,70,https://audio-cdn.tarteel.ai/quran/husary/113005.mp3
113,Al-Falaq,5,Husary,2,1480,2360,880,https://audio-cdn.tarteel.ai/quran/husary/113005.mp3
113,Al-Falaq,5,Husary,3,2640,4000,1360,https://audio-cdn.tarteel.ai/quran/husary/113005.mp3
113,Al-Falaq,5,Husary,4,4960,5160,200,https://audio-cdn.tarteel.ai/quran/husary/113005.mp3
113,Al-Falaq,5,Husary,5,5720,7720,2000,https://audio-cdn.tarteel.ai/quran/husary/113005.mp3
