surah_number,surah_name,ayah_number,reciter,word_number,start_time_ms,end_time_ms,duration_ms,audio_url
1,Al-Fatiha,1,Mishary,1,0,560,560,https://audio-cdn.tarteel.ai/quran/alafasy/001001.mp3
1,Al-Fatiha,1,Mishary,2,760,1200,440,https://audio-cdn.tarteel.ai/quran/alafasy/001001.mp3
1,Al-Fatiha,1,Mishary,3,2000,2360,360,https://audio-cdn.tarteel.ai/quran/alafasy/001001.mp3
1,Al-Fatiha,1,Mishary,4,2680,6120,3440,https://audio-cdn.tarteel.ai/quran/alafasy/001001.mp3
1,Al-Fatiha,2,Mishary,1,360,840,480,https://audio-cdn.tarteel.ai/quran/alafasy/001002.mp3
1,Al-Fatiha,2,Mishary,2,1210,1310,100,https://audio-cdn.tarteel.ai/quran/alafasy/001002.mp3
1,Al-Fatiha,2,Mishary,3,2170,2270,100,https://audio-cdn.tarteel.ai/quran/alafasy/001002.mp3
1,Al-Fatiha,2,Mishary,4,2440,5640,3200,https://audio-cdn.tarteel.ai/quran/alafasy/001002.mp3
1,Al-Fatiha,3,Mishary,1,760,1120,360,https://audio-cdn.tarteel.ai/quran/alafasy/001003.mp3
1,Al-Fatiha,3,Mishary,2,1440,4680,3240,https://audio-cdn.tarteel.ai/quran/alafasy/001003.mp3
1,Al-Fatiha,4,Mishary,1,0,640,640,https://audio-cdn.tarteel.ai/quran/alafasy/001004.mp3
1,Al-Fatiha,4,Mishary,2,840,1280,440,https://audio-cdn.tarteel.ai/quran/alafasy/001004.mp3
1,Al-Fatiha,4,Mishary,3,1640,4680,3040,https://audio-cdn.tarteel.ai/quran/alafasy/001004.mp3
1,Al-Fatiha,5,Mishary,1,0,760,760,https://audio-cdn.tarteel.ai/quran/alafasy/001005.mp3
1,Al-Fatiha,5,Mishary,2,920,1680,760,https://audio-cdn.tarteel.ai/quran/alafasy/001005.mp3
1,Al-Fatiha,5,Mishary,3,1720,2640,920,https://audio-cdn.tarteel.ai/quran/alafasy/001005.mp3
1,Al-Fatiha,5,Mishary,4,2840,6760,3920,https://audio-cdn.tarteel.ai/quran/alafasy/001005.mp3
1,Al-Fatiha,6,Mishary,1,0,600,600,https://audio-cdn.tarteel.ai/quran/alafasy/001006.mp3
1,Al-Fatiha,6,Mishary,2,880,1520,640,https://audio-cdn.tarteel.ai/quran/alafasy/001006.mp3
1,Al-Fatiha,6,Mishary,3,1800,5640,3840,https://audio-cdn.tarteel.ai/quran/alafasy/001006.mp3
1,Al-Fatiha,7,Mishary,1,0,640,640,https://audio-cdn.tarteel.ai/quran/alafasy/001007.mp3
1,Al-Fatiha,7,Mishary,2,880,1280,400,https://audio-cdn.tarteel.ai/quran/alafasy/001007.mp3
1,Al-Fatiha,7,Mishary,3,1680,2480,800,https://audio-cdn.tarteel.ai/quran/alafasy/001007.mp3
1,Al-Fatiha,7,Mishary,4,2880,3280,400,https://audio-cdn.tarteel.ai/quran/alafasy/001007.mp3
1,Al-Fatiha,7,Mishary,5,3480,3600,120,https://audio-cdn.tarteel.ai/quran/alafasy/001007.mp3
1,Al-Fatiha,7,Mishary,6,4360,5200,840,https://audio-cdn.tarteel.ai/quran/alafasy/001007.mp3
1,Al-Fatiha,7,Mishary,7,5600,5960,360,https://audio-cdn.tarteel.ai/quran/alafasy/001007.mp3
1,Al-Fatiha,7,Mishary,8,6250,6350,100,https://audio-cdn.tarteel.ai/quran/alafasy/001007.mp3
1,Al-Fatiha,7,Mishary,9,6720,13280,6560,https://audio-cdn.tarteel.ai/quran/alafasy/001007.mp3
82,Al-Infitar,1,Mishary,1,0,320,320,https://audio-cdn.tarteel.ai/quran/alafasy/082001.mp3
82,Al-Infitar,1,Mishary,2,600,3080,2480,https://audio-cdn.tarteel.ai/quran/alafasy/082001.mp3
82,Al-Infitar,1,Mishary,3,3360,4920,1560,https://audio-cdn.tarteel.ai/quran/alafasy/082001.mp3
82,Al-Infitar,2,Mishary,1,0,560,560,https://audio-cdn.tarteel.ai/quran/alafasy/082002.mp3
82,Al-Infitar,2,Mishary,2,720,1880,1160,https://audio-cdn.tarteel.ai/quran/alafasy/082002.mp3
82,Al-Infitar,2,Mishary,3,2160,4680,2520,https://audio-cdn.tarteel.ai/quran/alafasy/082002.mp3
82,Al-Infitar,3,Mishary,1,0,480,480,https://audio-cdn.tarteel.ai/quran/alafasy/082003.mp3
82,Al-Infitar,3,Mishary,2,600,1480,880,https://audio-cdn.tarteel.ai/quran/alafasy/082003.mp3
82,Al-Infitar,3,Mishary,3,1560,2720,1160,https://audio-cdn.tarteel.ai/quran/alafasy/082003.mp3
82,Al-Infitar,4,Mishary,1,0,600,600,https://audio-cdn.tarteel.ai/quran/alafasy/082004.mp3
82,Al-Infitar,4,Mishary,2,880,1600,720,https://audio-cdn.tarteel.ai/quran/alafasy/082004.mp3
82,Al-Infitar,4,Mishary,3,1680,3400,1720,https://audio-cdn.tarteel.ai/quran/alafasy/082004.mp3
82,Al-Infitar,5,Mishary,1,0,720,720,https://audio-cdn.tarteel.ai/quran/alafasy/082005.mp3
82,Al-Infitar,5,Mishary,2,1200,1400,200,https://audio-cdn.tarteel.ai/quran/alafasy/082005.mp3
82,Al-Infitar,5,Mishary,3,2009,2109,100,https://audio-cdn.tarteel.ai/quran/alafasy/082005.mp3
82,Al-Infitar,5,Mishary,4,2600,3640,1040,https://audio-cdn.tarteel.ai/quran/alafasy/082005.mp3
82,Al-Infitar,5,Mishary,5,3800,5720,1920,https://audio-cdn.tarteel.ai/quran/alafasy/082005.mp3
82,Al-Infitar,6,Mishary,1,0,70,70,https://audio-cdn.tarteel.ai/quran/alafasy/082006.mp3
82,Al-Infitar,6,Mishary,2,40,2520,2480,https://audio-cdn.tarteel.ai/quran/alafasy/082006.mp3
82,Al-Infitar,6,Mishary,3,2920,4280,1360,https://audio-cdn.tarteel.ai/quran/alafasy/082006.mp3
82,Al-Infitar,6,Mishary,4,4410,4510,100,https://audio-cdn.tarteel.ai/quran/alafasy/082006.mp3
82,Al-Infitar,6,Mishary,5,4840,5640,800,https://audio-cdn.tarteel.ai/quran/alafasy/082006.mp3
82,Al-Infitar,6,Mishary,6,5800,6680,880,https://audio-cdn.tarteel.ai/quran/alafasy/082006.mp3
82,Al-Infitar,6,Mishary,7,6840,9560,2720,https://audio-cdn.tarteel.ai/quran/alafasy/082006.mp3
82,Al-Infitar,7,Mishary,1,0,70,70,https://audio-cdn.tarteel.ai/quran/alafasy/082007.mp3
82,Al-Infitar,7,Mishary,2,880,1640,760,https://audio-cdn.tarteel.ai/quran/alafasy/082007.mp3
82,Al-Infitar,7,Mishary,3,1800,2960,1160,https://audio-cdn.tarteel.ai/quran/alafasy/082007.mp3
82,Al-Infitar,7,Mishary,4,3160,4680,1520,https://audio-cdn.tarteel.ai/quran/alafasy/082007.mp3
82,Al-Infitar,8,Mishary,1,0,70,70,https://audio-cdn.tarteel.ai/quran/alafasy/082008.mp3
82,Al-Infitar,8,Mishary,2,1240,1400,160,https://audio-cdn.tarteel.ai/quran/alafasy/082008.mp3
82,Al-Infitar,8,Mishary,3,2080,2920,840,https://audio-cdn.tarteel.ai/quran/alafasy/082008.mp3
82,Al-Infitar,8,Mishary,4,3410,3510,100,https://audio-cdn.tarteel.ai/quran/alafasy/082008.mp3
82,Al-Infitar,8,Mishary,5,4040,4280,240,https://audio-cdn.tarteel.ai/quran/alafasy/082008.mp3
82,Al-Infitar,8,Mishary,6,5840,7520,1680,https://audio-cdn.tarteel.ai/quran/alafasy/082008.mp3
82,Al-Infitar,9,Mishary,1,0,440,440,https://audio-cdn.tarteel.ai/quran/alafasy/082009.mp3
82,Al-Infitar,9,Mishary,2,690,790,100,https://audio-cdn.tarteel.ai/quran/alafasy/082009.mp3
82,Al-Infitar,9,Mishary,3,1440,2280,840,https://audio-cdn.tarteel.ai/quran/alafasy/082009.mp3
82,Al-Infitar,9,Mishary,4,2760,5680,2920,https://audio-cdn.tarteel.ai/quran/alafasy/082009.mp3
82,Al-Infitar,10,Mishary,1,0,70,70,https://audio-cdn.tarteel.ai/quran/alafasy/082010.mp3
82,Al-Infitar,10,Mishary,2,1520,1920,400,https://audio-cdn.tarteel.ai/quran/alafasy/082010.mp3
82,Al-Infitar,10,Mishary,3,2240,5520,3280,https://audio-cdn.tarteel.ai/quran/alafasy/082010.mp3
82,Al-Infitar,11,Mishary,1,0,640,640,https://audio-cdn.tarteel.ai/quran/alafasy/082011.mp3
82,Al-Infitar,11,Mishary,2,1200,4360,3160,https://audio-cdn.tarteel.ai/quran/alafasy/082011.mp3
82,Al-Infitar,12,Mishary,1,690,790,100,https://audio-cdn.tarteel.ai/quran/alafasy/082012.mp3
82,Al-Infitar,12,Mishary,2,1130,1230,100,https://audio-cdn.tarteel.ai/quran/alafasy/082012.mp3
82,Al-Infitar,12,Mishary,3,1520,4320,2800,https://audio-cdn.tarteel.ai/quran/alafasy/082012.mp3
82,Al-Infitar,13,Mishary,1,0,70,70,https://audio-cdn.tarteel.ai/quran/alafasy/082013.mp3
82,Al-Infitar,13,Mishary,2,1240,2240,1000,https://audio-cdn.tarteel.ai/quran/alafasy/082013.mp3
82,Al-Infitar,13,Mishary,3,2400,2640,240,https://audio-cdn.tarteel.ai/quran/alafasy/082013.mp3
82,Al-Infitar,13,Mishary,4,3000,5360,2360,https://audio-cdn.tarteel.ai/quran/alafasy/082013.mp3
82,Al-Infitar,14,Mishary,1,0,70,70,https://audio-cdn.tarteel.ai/quran/alafasy/082014.mp3
82,Al-Infitar,14,Mishary,2,1400,2320,920,https://audio-cdn.tarteel.ai/quran/alafasy/082014.mp3
82,Al-Infitar,14,Mishary,3,2480,2760,280,https://audio-cdn.tarteel.ai/quran/alafasy/082014.mp3
82,Al-Infitar,14,Mishary,4,3120,5680,2560,https://audio-cdn.tarteel.ai/quran/alafasy/082014.mp3
82,Al-Infitar,15,Mishary,1,0,1040,1040,https://audio-cdn.tarteel.ai/quran/alafasy/082015.mp3
82,Al-Infitar,15,Mishary,2,1370,1470,100,https://audio-cdn.tarteel.ai/quran/alafasy/082015.mp3
82,Al-Infitar,15,Mishary,3,2320,4640,2320,https://audio-cdn.tarteel.ai/quran/alafasy/082015.mp3
82,Al-Infitar,16,Mishary,1,0,70,70,https://audio-cdn.tarteel.ai/quran/alafasy/082016.mp3
82,Al-Infitar,16,Mishary,2,480,600,120,https://audio-cdn.tarteel.ai/quran/alafasy/082016.mp3
82,Al-Infitar,16,Mishary,3,1000,1480,480,https://audio-cdn.tarteel.ai/quran/alafasy/082016.mp3
82,Al-Infitar,16,Mishary,4,1800,6720,4920,https://audio-cdn.tarteel.ai/quran/alafasy/082016.mp3
82,Al-Infitar,17,Mishary,1,0,70,70,https://audio-cdn.tarteel.ai/quran/alafasy/082017.mp3
82,Al-Infitar,17,Mishary,2,1720,2400,680,https://audio-cdn.tarteel.ai/quran/alafasy/082017.mp3
82,Al-Infitar,17,Mishary,3,2610,2710,100,https://audio-cdn.tarteel.ai/quran/alafasy/082017.mp3
82,Al-Infitar,17,Mishary,4,3000,3560,560,https://audio-cdn.tarteel.ai/quran/alafasy/082017.mp3
82,Al-Infitar,17,Mishary,5,3920,6440,2520,https://audio-cdn.tarteel.ai/quran/alafasy/082017.mp3
82,Al-Infitar,18,Mishary,1,0,720,720,https://audio-cdn.tarteel.ai/quran/alafasy/082018.mp3
82,Al-Infitar,18,Mishary,2,930,1030,100,https://audio-cdn.tarteel.ai/quran/alafasy/082018.mp3
82,Al-Infitar,18,Mishary,3,2480,3160,680,https://audio-cdn.tarteel.ai/quran/alafasy/082018.mp3
82,Al-Infitar,18,Mishary,4,3330,3430,100,https://audio-cdn.tarteel.ai/quran/alafasy/082018.mp3
82,Al-Infitar,18,Mishary,5,3720,4320,600,https://audio-cdn.tarteel.ai/quran/alafasy/082018.mp3
82,Al-Infitar,18,Mishary,6,4720,7280,2560,https://audio-cdn.tarteel.ai/quran/alafasy/082018.mp3
82,Al-Infitar,19,Mishary,1,0,70,70,https://audio-cdn.tarteel.ai/quran/alafasy/082019.mp3
82,Al-Infitar,19,Mishary,2,610,710,100,https://audio-cdn.tarteel.ai/quran/alafasy/082019.mp3
82,Al-Infitar,19,Mishary,3,960,1880,920,https://audio-cdn.tarteel.ai/quran/alafasy/082019.mp3
82,Al-Infitar,19,Mishary,4,2360,2520,160,https://audio-cdn.tarteel.ai/quran/alafasy/082019.mp3
82,Al-Infitar,19,Mishary,5,2840,3560,720,https://audio-cdn.tarteel.ai/quran/alafasy/082019.mp3
82,Al-Infitar,19,Mishary,6,4410,4510,100,https://audio-cdn.tarteel.ai/quran/alafasy/082019.mp3
82,Al-Infitar,19,Mishary,7,6320,7320,1000,https://audio-cdn.tarteel.ai/quran/alafasy/082019.mp3
82,Al-Infitar,19,Mishary,8,7480,8560,1080,https://audio-cdn.tarteel.ai/quran/alafasy/082019.mp3
82,Al-Infitar,19,Mishary,9,9370,9470,100,https://audio-cdn.tarteel.ai/quran/alafasy/082019.mp3
109,Al-Kafirun,1,Mishary,1,0,90,90,https://audio-cdn.tarteel.ai/quran/alafasy/109001.mp3
109,Al-Kafirun,1,Mishary,2,470,570,100,https://audio-cdn.tarteel.ai/quran/alafasy/109001.mp3
109,Al-Kafirun,1,Mishary,3,560,3160,2600,https://audio-cdn.tarteel.ai/quran/alafasy/109001.mp3
109,Al-Kafirun,1,Mishary,4,3360,7560,4200,https://audio-cdn.tarteel.ai/quran/alafasy/109001.mp3
109,Al-Kafirun,2,Mishary,1,0,70,70,https://audio-cdn.tarteel.ai/quran/alafasy/109002.mp3
109,Al-Kafirun,2,Mishary,2,2360,3320,960,https://audio-cdn.tarteel.ai/quran/alafasy/109002.mp3
109,Al-Kafirun,2,Mishary,3,3370,3470,100,https://audio-cdn.tarteel.ai/quran/alafasy/109002.mp3
109,Al-Kafirun,2,Mishary,4,3720,7480,3760,https://audio-cdn.tarteel.ai/quran/alafasy/109002.mp3
109,Al-Kafirun,3,Mishary,1,0,70,70,https://audio-cdn.tarteel.ai/quran/alafasy/109003.mp3
109,Al-Kafirun,3,Mishary,2,2120,3160,1040,https://audio-cdn.tarteel.ai/quran/alafasy/109003.mp3
109,Al-Kafirun,3,Mishary,3,3760,4680,920,https://audio-cdn.tarteel.ai/quran/alafasy/109003.mp3
109,Al-Kafirun,3,Mishary,4,5090,5190,100,https://audio-cdn.tarteel.ai/quran/alafasy/109003.mp3
109,Al-Kafirun,3,Mishary,5,6720,8280,1560,https://audio-cdn.tarteel.ai/quran/alafasy/109003.mp3
109,Al-Kafirun,4,Mishary,1,0,70,70,https://audio-cdn.tarteel.ai/quran/alafasy/109004.mp3
109,Al-Kafirun,4,Mishary,2,2040,2480,440,https://audio-cdn.tarteel.ai/quran/alafasy/109004.mp3
109,Al-Kafirun,4,Mishary,3,2680,3440,760,https://audio-cdn.tarteel.ai/quran/alafasy/109004.mp3
109,Al-Kafirun,4,Mishary,4,4210,4310,100,https://audio-cdn.tarteel.ai/quran/alafasy/109004.mp3
109,Al-Kafirun,4,Mishary,5,4880,5680,800,https://audio-cdn.tarteel.ai/quran/alafasy/109004.mp3
109,Al-Kafirun,5,Mishary,1,0,70,70,https://audio-cdn.tarteel.ai/quran/alafasy/109005.mp3
109,Al-Kafirun,5,Mishary,2,1920,3160,1240,https://audio-cdn.tarteel.ai/quran/alafasy/109005.mp3
109,Al-Kafirun,5,Mishary,3,3720,4640,920,https://audio-cdn.tarteel.ai/quran/alafasy/109005.mp3
109,Al-Kafirun,5,Mishary,4,5130,5230,100,https://audio-cdn.tarteel.ai/quran/alafasy/109005.mp3
109,Al-Kafirun,5,Mishary,5,6880,8480,1600,https://audio-cdn.tarteel.ai/quran/alafasy/109005.mp3
109,Al-Kafirun,6,Mishary,1,0,320,320,https://audio-cdn.tarteel.ai/quran/alafasy/109006.mp3
109,Al-Kafirun,6,Mishary,2,640,1440,800,https://audio-cdn.tarteel.ai/quran/alafasy/109006.mp3
109,Al-Kafirun,6,Mishary,3,1800,2400,600,https://audio-cdn.tarteel.ai/quran/alafasy/109006.mp3
109,Al-Kafirun,6,Mishary,4,2600,6280,3680,https://audio-cdn.tarteel.ai/quran/alafasy/109006.mp3
111,Al-Lahab,1,Mishary,1,0,640,640,https://audio-cdn.tarteel.ai/quran/alafasy/111001.mp3
111,Al-Lahab,1,Mishary,2,840,1240,400,https://audio-cdn.tarteel.ai/quran/alafasy/111001.mp3
111,Al-Lahab,1,Mishary,3,3040,3560,520,https://audio-cdn.tarteel.ai/quran/alafasy/111001.mp3
111,Al-Lahab,1,Mishary,4,3880,4440,560,https://audio-cdn.tarteel.ai/quran/alafasy/111001.mp3
111,Al-Lahab,1,Mishary,5,5520,7440,1920,https://audio-cdn.tarteel.ai/quran/alafasy/111001.mp3
111,Al-Lahab,2,Mishary,1,0,70,70,https://audio-cdn.tarteel.ai/quran/alafasy/111002.mp3
111,Al-Lahab,2,Mishary,2,2080,2840,760,https://audio-cdn.tarteel.ai/quran/alafasy/111002.mp3
111,Al-Lahab,2,Mishary,3,3530,3630,100,https://audio-cdn.tarteel.ai/quran/alafasy/111002.mp3
111,Al-Lahab,2,Mishary,4,3800,4520,720,https://audio-cdn.tarteel.ai/quran/alafasy/111002.mp3
111,Al-Lahab,2,Mishary,5,4810,4910,100,https://audio-cdn.tarteel.ai/quran/alafasy/111002.mp3
111,Al-Lahab,2,Mishary,6,5480,7200,1720,https://audio-cdn.tarteel.ai/quran/alafasy/111002.mp3
111,Al-Lahab,3,Mishary,1,0,760,760,https://audio-cdn.tarteel.ai/quran/alafasy/111003.mp3
111,Al-Lahab,3,Mishary,2,1040,1560,520,https://audio-cdn.tarteel.ai/quran/alafasy/111003.mp3
111,Al-Lahab,3,Mishary,3,2680,3400,720,https://audio-cdn.tarteel.ai/quran/alafasy/111003.mp3
111,Al-Lahab,3,Mishary,4,3640,5200,1560,https://audio-cdn.tarteel.ai/quran/alafasy/111003.mp3
111,Al-Lahab,4,Mishary,1,0,1200,1200,https://audio-cdn.tarteel.ai/quran/alafasy/111004.mp3
111,Al-Lahab,4,Mishary,2,1480,3680,2200,https://audio-cdn.tarteel.ai/quran/alafasy/111004.mp3
111,Al-Lahab,4,Mishary,3,4080,5640,1560,https://audio-cdn.tarteel.ai/quran/alafasy/111004.mp3
111,Al-Lahab,5,Mishary,1,0,70,70,https://audio-cdn.tarteel.ai/quran/alafasy/111005.mp3
111,Al-Lahab,5,Mishary,2,320,1160,840,https://audio-cdn.tarteel.ai/quran/alafasy/111005.mp3
111,Al-Lahab,5,Mishary,3,1440,2080,640,https://audio-cdn.tarteel.ai/quran/alafasy/111005.mp3
111,Al-Lahab,5,Mishary,4,3170,3270,100,https://audio-cdn.tarteel.ai/quran/alafasy/111005.mp3
111,Al-Lahab,5,Mishary,5,4360,6480,2120,https://audio-cdn.tarteel.ai/quran/alafasy/111005.mp3
112,Al-Ikhlas,1,Mishary,1,0,70,70,https://audio-cdn.tarteel.ai/quran/alafasy/112001.mp3
112,Al-Ikhlas,1,Mishary,2,360,680,320,https://audio-cdn.tarteel.ai/quran/alafasy/112001.mp3
112,Al-Ikhlas,1,Mishary,3,930,1030,100,https://audio-cdn.tarteel.ai/quran/alafasy/112001.mp3
112,Al-Ikhlas,1,Mishary,4,1880,3040,1160,https://audio-cdn.tarteel.ai/quran/alafasy/112001.mp3
112,Al-Ikhlas,2,Mishary,1,290,390,100,https://audio-cdn.tarteel.ai/quran/alafasy/112002.mp3
112,Al-Ikhlas,2,Mishary,2,1200,2600,1400,https://audio-cdn.tarteel.ai/quran/alafasy/112002.mp3
112,Al-Ikhlas,3,Mishary,1,0,320,320,https://audio-cdn.tarteel.ai/quran/alafasy/112003.mp3
112,Al-Ikhlas,3,Mishary,2,440,1000,560,https://audio-cdn.tarteel.ai/quran/alafasy/112003.mp3
112,Al-Ikhlas,3,Mishary,3,1080,1600,520,https://audio-cdn.tarteel.ai/quran/alafasy/112003.mp3
112,Al-Ikhlas,3,Mishary,4,1720,3040,1320,https://audio-cdn.tarteel.ai/quran/alafasy/112003.mp3
112,Al-Ikhlas,4,Mishary,1,0,520,520,https://audio-cdn.tarteel.ai/quran/alafasy/112004.mp3
112,Al-Ikhlas,4,Mishary,2,680,1000,320,https://audio-cdn.tarteel.ai/quran/alafasy/112004.mp3
112,Al-Ikhlas,4,Mishary,3,1610,1710,100,https://audio-cdn.tarteel.ai/quran/alafasy/112004.mp3
112,Al-Ikhlas,4,Mishary,4,2000,2600,600,https://audio-cdn.tarteel.ai/quran/alafasy/112004.mp3
112,Al-Ikhlas,4,Mishary,5,3200,4920,1720,https://audio-cdn.tarteel.ai/quran/alafasy/112004.mp3
113,Al-Falaq,1,Mishary,1,0,70,70,https://audio-cdn.tarteel.ai/quran/alafasy/113001.mp3
113,Al-Falaq,1,Mishary,2,400,1120,720,https://audio-cdn.tarteel.ai/quran/alafasy/113001.mp3
113,Al-Falaq,1,Mishary,3,1190,1290,100,https://audio-cdn.tarteel.ai/quran/alafasy/113001.mp3
113,Al-Falaq,1,Mishary,4,2240,3520,1280,https://audio-cdn.tarteel.ai/quran/alafasy/113001.mp3
113,Al-Falaq,2,Mishary,1,0,70,70,https://audio-cdn.tarteel.ai/quran/alafasy/113002.mp3
113,Al-Falaq,2,Mishary,2,1160,1840,680,https://audio-cdn.tarteel.ai/quran/alafasy/113002.mp3
113,Al-Falaq,2,Mishary,3,1970,2070,100,https://audio-cdn.tarteel.ai/quran/alafasy/113002.mp3
113,Al-Falaq,2,Mishary,4,2330,2430,100,https://audio-cdn.tarteel.ai/quran/alafasy/113002.mp3
113,Al-Falaq,3,Mishary,1,0,70,70,https://audio-cdn.tarteel.ai/quran/alafasy/113003.mp3
113,Al-Falaq,3,Mishary,2,1280,1960,680,https://audio-cdn.tarteel.ai/quran/alafasy/113003.mp3
113,Al-Falaq,3,Mishary,3,2160,2880,720,https://audio-cdn.tarteel.ai/quran/alafasy/113003.mp3
113,Al-Falaq,3,Mishary,4,3440,3600,160,https://audio-cdn.tarteel.ai/quran/alafasy/113003.mp3
113,Al-Falaq,3,Mishary,5,3800,5080,1280,https://audio-cdn.tarteel.ai/quran/alafasy/113003.mp3
113,Al-Falaq,4,Mishary,1,0,70,70,https://audio-cdn.tarteel.ai/quran/alafasy/113004.mp3
113,Al-Falaq,4,Mishary,2,1240,1960,720,https://audio-cdn.tarteel.ai/quran/alafasy/113004.mp3
113,Al-Falaq,4,Mishary,3,2640,4160,1520,https://audio-cdn.tarteel.ai/quran/alafasy/113004.mp3
113,Al-Falaq,4,Mishary,4,4370,4470,100,https://audio-cdn.tarteel.ai/quran/alafasy/113004.mp3
113,Al-Falaq,4,Mishary,5,4640,6040,1400,https://audio-cdn.tarteel.ai/quran/alafasy/113004.mp3
113,Al-Falaq,5,Mishary,1,0,70,70,https://audio-cdn.tarteel.ai/quran/alafasy/113005.mp3
113,Al-Falaq,5,Mishary,2,1120,1800,680,https://audio-cdn.tarteel.ai/quran/alafasy/113005.mp3
113,Al-Falaq,5,Mishary,3,2000,2800,800,https://audio-cdn.tarteel.ai/quran/alafasy/113005.mp3
113,Al-Falaq,5,Mishary,4,3320,3480,160,https://audio-cdn.tarteel.ai/quran/alafasy/113005.mp3
113,Al-Falaq,5,Mishary,5,3680,5720,2040,https://audio-cdn.tarteel.ai/quran/alafasy/113005.mp3
